screwdriver	pliers,
screwdriver,screwdriver	pliers,screwdriver,
screwdriver,screwdriver	screwdriver,screwdriver,
screwdriver,screwdriver	screwdriver,screwdriver,
screwdriver,screwdriver,tapemeasure	tapemeasure,screwdriver,pliers,pliers,pliers,
screwdriver,screwdriver,tapemeasure	tapemeasure,screwdriver,pliers,
screwdriver,screwdriver,tapemeasure,screw	tapemeasure,screw,screwdriver,screwdriver,pliers,
screwdriver,screwdriver,screw	screwdriver,screw,
screwdriver,wrench,screw	wrench,screw,
screwdriver,wrench,screw	wrench,screw,hammer,
screwdriver,wrench,screw	screw,wrench,
screwdriver,wrench,screw	screw,wrench,
screwdriver,wrench,screw	wrench,screw,
screw,wrench,screwdriver	screw,wrench,wrench,
screw,wrench,screwdriver	wrench,screw,pliers,screw,
screw,screw,wrench,screwdriver	screw,wrench,screw,pliers,screwdriver,
screw,screw,wrench,screwdriver	screw,screw,wrench,pliers,
screw,screw,wrench,screwdriver	screw,screw,pliers,pliers,
screw,screw,wrench,screwdriver	screw,screw,wrench,
screw,screw,wrench,screwdriver	screw,screw,wrench,
screw,screw,wrench,screwdriver	screw,screw,wrench,
wrench,screw,screw,screwdriver	wrench,screw,screw,
screw,screw,wrench,screwdriver	wrench,screw,screw,pliers,
wrench,screw,screw	wrench,screw,screw,pliers,
wrench,screw,screw	wrench,screw,screw,
screw,screw,wrench	wrench,screw,screw,hammer,
wrench,screw,screw,hammer	screw,screw,wrench,
hammer,hammer,screw,screw	hammer,screw,screw,
screw,hammer,hammer,screw	screw,screw,
screw,hammer,screw	screw,screw,
screw,screw,hammer,screw	screw,screw,screw,
screw,screwdriver,screw,hammer,screw	screw,screw,screw,screwdriver,pliers,
screw,pliers,screw,hammer,screw	screw,pliers,screw,screw,
pliers,screw,hammer,screw	pliers,screw,screw,
screw,pliers,hammer,screw	pliers,screw,screw,
pliers,tapemeasure,hammer,screw	pliers,tapemeasure,screw,screw,
tapemeasure,hammer,screw	screw,
tapemeasure,tapemeasure,screw	tapemeasure,screw,
tapemeasure,tapemeasure,hammer,screw	pliers,screw,
tapemeasure,tapemeasure,wrench,hammer,screw	pliers,screw,screw,
wrench,tapemeasure,hammer,screw	screw,pliers,screw,
wrench,tapemeasure,wrench,hammer	pliers,screw,
wrench,wrench,hammer	pliers,screw,
wrench,wrench,screw	screw,screw,
wrench,wrench,screw,screw,tapemeasure	screw,screw,screw,
screw,wrench,wrench,screwdriver,tapemeasure	screw,screw,pliers,
wrench,pliers,screw,screwdriver,tapemeasure	screw,screw,pliers,screwdriver,hammer,
wrench,tapemeasure,pliers,screw,screwdriver,tapemeasure	screw,pliers,tapemeasure,screw,hammer,
screw,wrench,pliers,screw,tapemeasure,screwdriver,screw,tapemeasure	pliers,tapemeasure,screw,screw,screw,screw,hammer,
screw,wrench,pliers,tapemeasure,screw,pliers,screw,tapemeasure	screw,pliers,tapemeasure,screw,screw,screw,
wcrew,wrench,pliers,screw,screwdriver,pliers,screw,tapemeasure	pliers,screw,screw,screw,hammer,screw,hammer,
screw,wrench,pliers,screwdriver,screw,pliers,screwdriver	pliers,screw,screw,pliers,screw,
screw,wrench,screwdriver,screw,screwdriver	screw,screw,screw,pliers,hammer,
screw,screwdriver,screw,pliers,screwdriver	pliers,pliers,screw,screw,pliers,hammer,pliers,
hammer,wcrew,screwdrier,pliers,screwdriver	pliers,pliers,screw,
screw,wrench,hammer	screw,screw,pliers,
screw,wrench,hammer	screw,screw,pliers,
screwdriver,hammer,pliers	pliers,screwdriver,pliers,
screwdriver,hammer,screw,pliers	pliers,screw,screwdriver,pliers,
screwdriver,pliers,pliers,screw	pliers,screw,screwdriver,pliers,hammer,
hammer,screw,pliers,pliers	pliers,screw,pliers,hammer,
hammer,wrench,screw,pliers,pliers	pliers,screw,wrench,pliers,
hammer,wrench,pliers,pliers,screw	pliers,screw,wrench,pliers,
hammer,wrench,screw,screw	screw,screw,wrench,
hammer,wrench,screw,screw,pliers	pliers,screw,screw,wrench,
hammer,pliers,screw,screw,pliers	pliers,screw,pliers,screw,hammer,
hammer,tapemeasure,pliers,pliers,screw,tapemeasure	pliers,pliers,screw,tapemeasure,
screw,pliers,tapemeasure,tapemeasure,wcrew,pliers	pliers,pliers,screw,hammer,tapemeasure,screw,
screw,screw,pliers,tapemeasure,tapemeasure,screw,pliers	pliers,pliers,screw,screw,tapemeasure,hammer,screw,
screwdriver,screw,pliers,tapemeasure,tapemeasure,screw,pliers	pliers,pliers,screw,pliers,tapemeasure,screw,screwdriver,
screwdriver,screw,tapemeasure,wrench,tapemeasure	screw,screw,tapemeasure,pliers,screwdriver,
screw,screwdriver,tapemeasure,tapemeasure,wrench,screwdriver	screw,tapemeasure,pliers,pliers,pliers,screw,screw,
screw,tapemeasure,screwdriver,screwdriver,wrench,tapemeasure	screw,screw,
screw,tapemeasure,tapemeasure,screwdriver,wrench,wrench	screw,tapemeasure,screw,pliers,
screwdriver,tapemeasure,tapemeasure,screwdriver,wrench,wrench	tapemeasure,screw,pliers,
screwdriver,tapemeasure,tapemeasure,screwdriver,wrench,screw,screw	screw,tapemeasure,screw,pliers,
screwdriver,tapemeasure,tapemeasure,hammer,wrench,screw,screw	screw,screw,tapemeasure,pliers,
screw,tapemeasure,tapemeasure,hammer,screw,pliers,screw	pliers,screw,tapemeasure,screw,
pliers,wrench,hammer	pliers,wrench,hammer,
tapemeasure,hammer	tapemeasure,pliers,
tapemeasure,pliers,pliers,hammer	pliers,pliers,pliers,
tapemeasure,crew,pliers,hammer,screw,pliers	pliers,screw,tapemeasure,pliers,screw,hammer,
tapemeasure,screw,pliers,screw,hammer,pliers	pliers,screw,tapemeasure,pliers,screw,hammer,
taper,measure,screw,hammer,hammer	screw,pliers,hammer,
tapemeasure,screw,pliers,hammer	screw,pliers,pliers,pliers,hammer,
tapemeasure,screw,screw,pliers,hammer	screw,screw,pliers,pliers,hammer,
screw,tapemeasure,hammer,tapemeasure	screw,screw,tapemeasure,pliers,hammer,
srew,screw,hammer,tapemeasure,tapemeasure	screw,screw,tapemeasure,pliers,hammer,
screwdriver,screw,hammer,tapemeasure	screw,pliers,pliers,tapemeasure,
screwdriver,screw,screw,screw,hammer,tapemeasure	screw,screw,screw,tapemeasure,pliers,pliers,
